111111111111111111111111
1P011001100000E000000111
100110011000000000000111
100110000001111111100001
100110000001100001100001
100110011111101101111001
100110011111101101111001
100000000000001100000001
100000000000001100000001
111111111111111111111111
