111111111111111111111111
1P011001100000E000000111
100110011000000000000111
100110000C0111111110C001
1001100000011C00C1100001
100110011111101101111001
100110011111111111111001
100000000000001100000001
100000000000001100000001
111111111111111111111111
