111111111111111111111111111111111111111
100000000000000000000000000000000000001
1P0000000000C00000000000000000000000001
100000000000000000000000000000000000001
100000000000E00000000000000000000011111
10000000000000000000000000000000001
11111111111111111111111111111111111
