11111111111111111
100P0000C00000001
1000000000000d001
10000000E00000001
11111111111111111
