11111111111111111111111111111111111111111111111111111
10000000000000000000000000000000000000000000000000001
10P000111111111111100000000011111111111111111000C0001
10000011111111111110000000001111111111111111100001111
1000000000000000000C000000001111111111111111100001111
10000000001111111110000000000000000000000000000001111
10000000001111111110000000000000000000000000000000001
10011111001111111110000011111100000000000000000000001
1001111100000000000000001111110C001111111111111111111
10011111000000000000000011111100001111111111111111111
100C0000000000000000000011111100000000000000000000001
100000000000000000000000000000000000000000000E0000001
11111111111111111111111111111111111111111111111111111
